******************************************
*       ** ***** *************************
*** ***  * **    *************************
*    *  #    *** *************************
*#***** *  *     *************************
* **    * ** *** *************************
*    **** ** *     ***********************
* ******* ** *** * ***********************
*         ****** *F***********************
******************************************
******************************************
******************************************
******************************************
******************************************
******************************************
******************************************
17****************************************