********************
*       ** ***** ***
*** ***  * **    ***
*    *  #    *** ***
*#***** *  *     ***
* **    * ** *** ***
*    **** ** *     *
* ******* ** *** * *
*         ****** *F*
********************