2*****************************************
*       ** ***** #**  ***#***** **********
*** ***  * **      #***           ********
*    *  #    *** * *  ***** ******  ******
* *#*** *  *     *   #*     *****    *****
* **    * ** *** *  *** ****#**** *#******
*    **** ** *    * ***           *    ***
* ******* ** *** ** ***#*   *** *** ** ***
*         #***** *  ********    **  **  **
****    *********       ** *** **** ** ***
****** **************** *****  **** **  **
***             #***    *****        ** **
*** ****#**** ******* ******  * ****#   **
***  ******    *       ***** *  ****** ***
*** ***  ******  *****    ** ***#***    **
***      **  ************    *********# F*
******************************************