2*****************************************
*       ** *****@#**  ***#***** ****   ***
*** ***  * **      #***       @   *  * *@*
*    *  #    *** * * @***** ***** * **   *
* *#*** *  *  @  *   #*     *****     ****
*@**    * ** *** *  *** ****#**** *#******
** @ **** ** *    * ***@      @   *    ***
*  ****** **@*** ** ***#*   *** *** ** ***
*         #***** *  ********    **  **  **
****    *********       ** *** **** ** ***
****** **************** *****  **** **  **
***            @#***   @*****    @   ** **
*** ****#**** ******* ******  * ****#   **
***@ ******     *    @ ***** *  ******@***
*** ***  ****** @*****    ** ***#**     **
***    @ **  ************ @  ****F| **#  *
******************************************