3***********************************************
*             *****   @**@  *****@******** |F| *
*** ***  * **   @*  ******* *****   ****** *** *
*    *  #    *** * *******    ***     ***  *** *
*#** ** *  *     *   ********   ** **  * @**** *
* **@   * ** **# ***   ****** ***  ***   ****  *
*    **** ** *     ***  ****# ***@** *  ****  **
* **** ** ** * * * ****@ ****  ******  ****  ***
*  **  @  **   * ******#  ** *    *   ***** ****
** *   ***** ***  ******* **@    **   ***** ****
**@** *****   @** ***@  * **** ***  *@  *** *#**
***   ****  ****   ****     *      ***  ***@  **
****   ********   ***** *** @ ********   **** **
***** ****@@ ****    @***** **  ***** ** **** **
***    ***** ***  *** *     ***  ***  **   ** **
***@*# *@    #   ****   ********  *  ***** *  **
******   *******   ****@    ****#   ******@  ***
************************************************