1*******************
*   @   **@*****@***
***** *@ * **@   ***
*    @* #    *** ***
*#*@*** *  *     ***
* **    * ** *** ***
*    ****  * *     *
* #***@** **@* * ***
*  @      *****  |F*
********************