4*********************************************************
*       ** ***** *****************************************
*** ***  * **    *****************************************
*    *  #    *** *****************************************
*#***** *  *     *****************************************
* **    * ** *** *****************************************
*    **** ** *     ***************************************
* ******* ** *** * ***************************************
*         ****** *F***************************************
**********************************************************
**********************************************************
**********************************************************
**********************************************************
**********************************************************
**********************************************************
**********************************************************
**********************************************************
**********************************************************
**********************************************************
**********************************************************
**********************************************************
**********************************************************
**********************************************************