4*********************************************************
*   *@  ** ***** ***@  ****@  ****@********# @   *********
*** ***  * **    *****@   *** ***   ***@****** ***********
*    *  #    *** ********@    *** *     ******  @   ******
*#*@***    *     ****   ***** *   *@******  ****  ********
* *     * ** *** ********       **#  *******  ***   ******
* *  **** ** *     **   * ***@******   ************   ****
*** ***** ** *** * ****** * * ********@*********   **  ***
*   *      ****** * ****  ***   *****  **********@**  ****
* ********    ******@   @****** ***@  #**********     ****
* *   *******@****** * **  **** **   *** @   ***   * *****
*  *******  ****  ****@ *******  * *   *****      #*  ****
**  ************#***** ********    ** * ****@  * *** *****
*** *   @   **** ***     #***** ****   @**    *****@ *****
***  ******  ***  *  *  **********   * *** ** ******#*****
**  @******* ****#* ***  @#*** @   * ****  **    *********
** ******* * *   ** *** ********* *   *** **#  ***** *****
*  **   **   *#* @  **  *********** *     *******   @*****
*  ** * @  ******* *   ***  **  **  **@** ***  @  ********
** *  ****  ****** *  * ********** **  **     ***#********
*  * *****#      * **    ******    ** ***#*** @ ***  *****
*@   **********#   ****#   |F|  **#** *   *********#******
**********************************************************