1*******************
*       ** ***** ***
*** ***  * **    ***
*    *  #    *** ***
*#***** *  *     ***
* **    * ** *** ***
*    ****  * *     *
* #****** ** * * * *
*         *****  *F*
********************