************************************************
*       ** ***** *******************************
*** ***  * **    *******************************
*    *  #    *** *******************************
*#***** *  *     *******************************
* **    * ** *** *******************************
*    **** ** *     *****************************
* ******* ** *** * *****************************
*         ****** *F*****************************
************************************************
************************************************
************************************************
************************************************
************************************************
************************************************
************************************************
************************************************
18**********************************************